11111111111111111111111111111111111111111111111111111111111111111111111111111
20000100010001010000000001000000010000000100000001000000000000010000000001011
11110101010101010111110101011101110111010101011101011111011111011101111101011
11010001000101000100010101000100010001010101000101010001000001000101000001011
11011111111101110111010101110111011101011101110111011101111101110101111101011
11000100000100010000010100010101000101000101010100010001000100010001000100011
11011101110111011111010111110101011101110101010101110111010111010111010111011
11000001010001010000010100000101010001010101010101000100010001010100010100011
11011111010101011111110101111101010111010101010101010101111101011101110101111
11010000010101000000010100010001000100010100010001010100010101000001000101011
11010111110111111111010111010101111111010111011111010111010101111111011101011
11010100000100000100010000000100000100010001010000010100000100000100010101011
11010101111101011101110111111111110101111101010111011101111111110101110101011
11010101000101000001000100000000010001000001010100010001000100000101000101011
11010101010101111111111101111111011111010111010111110111010101110101010101011
11010100010100000000000001000001000100010100010000010100010001000101010001011
11010111110111111111111111110111110101111101111111010101111111011101011111011
11010000010000010000010000000100000100000000000001010100010001010101000001011
11010111011111010111010101111101111111011111111101010111011101010101111101011
11000101000101000100010100000001000001010000010001000100010001010101000000011
11111101110101111101110111111111011101110111010111110101110111010101111111011
11000001000100010001000100000001000100000101010000010101010000000101000100011
11011111011111010111011101111101110111111101011111010101010111111101010111111
11010000010001010000010001000100010100000001000100010101010001010001010000011
11010111110101011111111101010111010111110111110101110101011101010111011111011
11000100000100000100000001010100010100010000010100010101010001010000000100011
11011101011111111101011111110101110101011101010111011101010111011111111101011
11010001000000000001000000010001010001000101010001000001000001000100000001011
11011111111111111111111111010111010111110101111101111111111101110101111111011
11010001000000000001000000010001000101000101000100000001000100000101000100011
11010101011111111101011111111101011101011101010111111101010111110101010101111
11000101000001000100010001000101000001010000010001000100010001000101010101011
11111101011101010111111101010101111111011101110101010111111101111101010101011
11000101000101010000010001010100010001000100010100010001000100000101010100011
11011101011101010111010111010111010101010111110111111101010111110101110111011
11000001010001010001000100010001000101010000010100010101010000010001000001011
11011111110111011101110101111101111101011111010101010101011101011111011111011
11010000010100010001000100010100010001010000010101010001010001000100000000011
11011101010101110111111111010111010111110111110101011111010111111101111111111
11000001000100010000000000000001000000000100000001000000010000000000000000311
11111111111111111111111111111111111111111111111111111111111111111111111111111