111111111111111111111111111111111111111111111111111
200100000000000100000000010000010100000000000100011
110101110111110111110111010111010101111101110101111
110101010100000000010001000101010000010001000100011
110101010111111111010101111101011111110111011101011
110100010100000001010101000001000000010101010101011
110111010101111101011101010101111111010101010101011
110001010100010001000001010100000001000100010001011
111101110111010111111111010111111111111101111101011
110100010100010001000001010000000000000100000101011
110111010101111101011101011111111111010111110111011
110000010100000101000100010000010100010000010100011
110111110111110101110111111101010101111111010101011
110100010000010101000100000101000101000100010101011
110101011101110101011111010101011101011101110101111
110001000100000101010000010001010001010001000100011
111111110101111101010111111111110111010111011101011
110000010101000001000100000001000100000001000101011
111101010111011111110101111101011111011111110101011
110001010000010000010101000101000001010100000101011
110111011111110111010101011101011101010101111101011
110001010000010100010101000101010001000101000101011
111101010111010101110101110101010111110101010101011
110001000100010101000100010001010001000100010101011
110101111111011101011111011101111101011111110101011
110101000001000001010001000100000001010000000101011
110111011101111111010101110101111111110111111101011
110001010101000000010101000101000000010100000101011
110101010101011111110101011111011111010101110111011
110100000100000000000101000000000001000001000000311
111111111111111111111111111111111111111111111111111