1111111111111111111111111111111111111111111111111111111111111111111111111111
2001000000000000000001000001000000000100000100000000000000000100000001000001
1101011111011111111101010101011111110101110101111111111111110101110101111101
1101000100010100000101010100010000010001010100000001000001000101010100010001
1101111101110101011101010111111111011111010101111101011101110101010111010101
1100000001000001010001010100000000010100000101000101000100010100010100000101
1111111111111111010111010101110111010101111101010101011111010111010111111101
1100000000000001010100010101010100000101000001010100010000010001010001000101
1101111101111101010111110101010111110101111101010111110111111101111101010101
1101000101000100010001000100010001000100000101010000000101000100000101010001
1101011101010111011101011111111101011111110111011111111101010111110101111111
1101000101010000000100010000000001010000010001010000010000010001000100000001
1101110101110111111111110101111111011111011101010111010111111101011111111101
1100000100010000010000010100010000010001000100010100010100000101000100000001
1111110111011111110111010111010111110101011111110101110111010101110101111101
1101000101000000000101010001010000000101010000010100010001010100000101000001
1101011101111111111101011101011111111101010101011111011101110111111101011111
1101010000010000000001000101000000010001000101000000000100000000010001000101
1101010111010111011111110101111111010111111101111111110111111111010111110101
1100010001000001000000010001000001010000000001000100000100000001000100000101
1101111111111101111101011111011101011111011111010101111111010111111101111101
1101000001000101000001010001000100010000010000010101000001010000010001000001
1101011101010111011111010111110111111111110111110101110101111101110111011101
1100010101010001010001000100010000000000010100000100000100000100010101000101
1111110101011101010101011101011111111111010101111111111111110111010101011101
1100010001000100010100010001000000000001000101000001010001000100010100010001
1101010111110111110111110111111101011101111101011101010101011101010111110101
1101000100000100010001000100000101010101000100010101000100000001010001000101
1101111101011101011111011101110101010101110111110101111111111111111101011101
1101000101000001000001010001000101010100010000010100000000000000010001000101
1101010101111111110101010111011111010111010111010111111111111111010111110101
1101010000000100010100010100000000010001000101000000000100010000010100000101
1101111111111101011111110111011111110111111101111111110101110111110101111101
1101000000000001000000010001010001000000000000010000000100010001000101000001
1101011111111111111111011101110101111101111111110111111111011101011101011111
1100010000010000000001000100000100000100000000000000000100000100010001000001
1111111101010101111111110111111111110111111111111111110101110111110101111111
1100000001010101000000010001000000010000000000000100010101000001000100000001
1101111111010111011111011101011111011111011111110101110101111111011111111101
1101000100010001000100010001000101010001010001000101000101000000010100010001
1101010101111101011101010111110101010101010101011101011101011111110101010111
1101010000000100010001010000000101000101010100010000010001000001000101010001
1101111111110111110111111111111101111101110111110111110101111101110101010101
1101000000010000010000000101000000010001000100010100000100000000000101010101
1101011111011111011111010101010111110111011101010101111111111111111101011101
1101010000010000000000010001010000010000010101000100000100000001000101000101
1101010111111111111111111111011111011111110101111111110101111101010101110101
1100010100010001000000010001010100000001000101000000010101000100010101010001
1101110101010101011111010101010101111111010101011111011101011111110101011101
1100010001000100000001000100000100000000010000010000000001000000000001000031
1111111111111111111111111111111111111111111111111111111111111111111111111111