1111111111111111111
2000010001000000011
1111010101110101011
1101010100010101011
1101010111011101011
1101010001000001011
1101010101111111011
1101010100010001011
1101011111010101011
1100000000010100311
1111111111111111111