111111111111111111111
200001000000010000011
111101110111010111111
110100000101010000011
110111111101010111011
110001000000010001011
110111011111111111011
110001010000010000011
110101010111010111011
110100000100000100311
111111111111111111111