1111111111111111111111111111111111111111111111
2001000000000100000000000001000000010000010001
1101011111110101111111111101011101011101011101
1101000001000101000000000101000101000101000101
1101111101010101110111111101011101110101110101
1100000101010100010100000100010001000100010101
1111110101010111010101110111010111011111010101
1100000101010100000100010001010101000000010001
1101111111011101111111011101110101111111111101
1101000001010001010001000101000100000000010001
1101011101010111010101010101011111111101010111
1101000100010000010101010101000000010001010001
1101010111110111110101110101111111010111011101
1101010000000100010100010100000000010100010001
1101111111111101010111010111111111110111110111
1101000000000001000101010100000100000100000101
1101011111111111111101010101110101110101111101
1100010001000001000001000101010001010001000001
1111110101011101011101111101011111011111011101
1100000101000101010100000101000000000001010001
1101111101110101010101111101011111111101011111
1100010101010100010100000001010000000101000001
1111010101010111110111111111010111011101111101
1100010000010100000100000000010101000100010001
1101111111110101111101111101110101110111010111
1100000100000100000000000101010001010100010001
1101110101111101111111111101011101010101111101
1101010101000101000100000001000100010101000001
1101010101010111010101111111010111010101011101
1100010000010000010001000000010000010000010031
1111111111111111111111111111111111111111111111