2011111111
1000000001
1011101101
1010000101
1010010101
1011011111
1010000001
1010100101
1111101111
1000100003
1010000101
1111111111