11111111111111111111111111111111111
20000100010001000000000100000000011
11110101010111011111010111011101011
11010001010000000100010001000101011
11011111011111111101111101011101011
11000100010000000100010101010001011
11010101110111110111010101010111011
11010001000100010000010001010100011
11011111011101111111110111010111011
11010000010001000000000100010001011
11010111111101011111111111111101011
11000100000001010000000000000001011
11111111011111010111111111111111011
11000000010001010000010000000100011
11011101110101010111010111011101111
11010100010100010100010001010001011
11010111010111111101111101010111011
11000101000100000101000001000100011
11110101111101110101011111111101011
11000000000001000001000000000001311
11111111111111111111111111111111111