111111111111111111111111111111111111111111111111111111111
244144410000000000004441444101000000000001000000000000011
114141411101111111114141414101011101111111010101111111111
114441444101444441444141414101010100000100010101000100011
111111114101411141411141414101010111110101110111010101011
110001444101410044410144414100010000010001000100010001011
111101411111411111110111114101111111011111011101111111011
110001444441444441000101444100000000000001010000000100011
110111111141111141010101411111011111111111010111111101111
110000000141444441010001444100014444444441000100000100011
111101110141411111011101114101114111111141011101110111011
110001000141410001000101444101444144444141000101000000011
110101111141411101010111411111411141114141110101111111011
110101444441444100010144414444410144414441010100010001011
110111411111114111110141114111110111411111010111010101011
110144414444414144410144444144444001410000000101000101011
110141114111414141410111111141114111410111111101111101011
114441004144414441410100014441444144410100010000010001011
114111114141110111410101014111410141110101011111010111111
114441444141000144410001014441410144410001000100010000011
111141411141110141111101011141411111411111110101111111011
114441410144410141000101000141444001410100000100000100011
114111410111411141010111010141114111410101111101110101011
114444410001444441010000010141014441410101000101000101011
111111111101111111011111111141011141410101010111010101011
110000000000010001000100000141000144410000010000010101011
110101111111110101010101110141110111110111110111110101111
110100000000000101010100010144444144410144410144410100011
110111111111111101010111010111114141411141411141411111011
110000000000000100010000010000004441444441444441444444311
111111111111111111111111111111111111111111111111111111111