111111111111111111111111111111111111111111111111111
200100000000000101000000000100000100000000000000011
110111110111110101011111010111011101011111111111011
110100000101000100010100010001010001000100000001011
110101111101011101110101111101010111110111010111011
110100000100010101000100000101010100010001010001011
110111110101110101011111110101010101011101011101011
110000000100010001000100000101000001010001000101011
111111111111010111110101111101111111010111110101011
110000010001010000000100010100000001010101000101011
110111011101011111011111010111111101110101011101011
110001010001000100010001010001000100000101010101011
111101010101110101110101010111010111111101010101011
110001000100010101000100010001010001000001010100011
110111111111010111011111111101011101010111010111111
110100000101010000010000000001010100010000010000011
110101110101011111110111111101010111111111110101111
110001000101000001000001000101000100000000010100011
110111011101111101011101110101110111011111010111011
110001010000000001010100010000010000010001010100011
111101011111110111010111011111011111110101011101111
110001000000010001000001000100000100000101000100011
110111111111011111111101110111111101110101110101011
110001000001000000000100010001000001010101010101011
111101010101111111011111011101011111010101010111011
110101010101000001010001010101000100010100010001011
110101110101111101010101010101110101010111111101011
110100010101000001010100010100010101010000000001011
110111010101011101010111110111010101011111111111011
110000000100010001000000000001000001000000000000311
111111111111111111111111111111111111111111111111111