111111111111111111111111111111111111111111111111111111111
200100000100000000010000000100010000000000010001000000011
110111010101111111110111010101110111110111010101010111011
110000010100000000000100010001000100010101000101010001011
111111110101111111110101111111011111010101110111011101111
110000010100010000010101000000000000010100000100000100011
110111010111010111010101011111111111010101111101111111011
110001010100010001010100010001000001010101000001010000011
111111010111111101010111110101011101110101011111010111111
110000010100010001010100000100010000000101010000010100011
110111010101010111010101111111011111111111010111010101011
110100010001010001010101000001010000010000010100010001011
110101111111011101011101010111010111010111111101011111011
110100010000010001000001010001010101000100000001000001011
110111110111110111110111111101010101111111011111011111011
110000010100000101000100000100010001000001000101010000011
110111010111010101011101110101111101011101110101010111011
110101010001010100000100010101000100010101000101010100011
110101011101010111111111010101010111110101011101010111011
110101000001010000000000010100010100000100010001010001011
110101111111111111111111010111111101011111110111011101111
110001000100000000000001010000000101000000000000010100011
111101010111011111111101111111110101111101111111110111011
110100010000010000000100000000010001000100000000000001011
110111111111110111010111111111010111010111111111111101011
110100010000010100010001000001010001010001000000000101011
110101010111010101011111010111011111011101011111110101011
110101010101000101010001010001000100010101000100000101011
110101010101111101110101011101110101110101110101111111011
110001000000000100000100000100000001000000000100000000311
111111111111111111111111111111111111111111111111111111111