111111111111111111111111111111111111111
244441000000000100000100000000000000011
111141011101111101011101011111110111111
110141000101000001000101000100010100011
110141010111011111010101110111010101011
110141010000014441010101010001000101011
110141111111114141110101011101111101011
110144414444444144410001000100000101011
110111414111111111410111011111110101011
110001414441000001410001000000010001011
110111410141111101411101110101011111011
110144410141000101410100010101000001011
110141111141010101410111010101111101011
110144414441010001410000010101010001011
110111414111011111411101111101010111011
110144414441010001444100000001000144411
110141110141010101114111110111111141411
110141000141010100014444410144444441411
110141111141010101111111411141111111411
110044444441000100000000444441000000311
111111111111111111111111111111111111111